1111111111111111111
101C0100000010001C1
11110101111010P0101
1C1001C100001000101
1010111101111101101
100000C10000C101001
1110110110101100011
1000100000100001011
10E0101010110101111
10001C1C100001000C1
1111111111111111111