1111111111111111111
1C0010001010C1000P1
1100100C10101100001
1110101110100100001
1C10100010110001111
1010001000100101001
1010111110101101111
1010001C100010000C1
10111010101110E0111
10000010000C1000001
1111111111111111111