11111111011111111111
10000W00000001000001
0000000PP00011100001
10000000000010100001
11111111110111111111