11111111
1ECCC001
10000P11
11111101