111111111111111
10C10C1C10C0001
1001000P10000C1
101101C1100E101
100001110001111
101000000100001
1C100100C1000C1
111111111111111