111111111111111
1C01C01010C0001
1001000P1000001
101101011000101
100001110001111
101000000100001
101E01000100001
111111111111111