1111111111111111111
101C0100000010001C1
11110101111010P0101
1C1001C100001000101
1010111101111101101
100000010000C101001
1110110110101100011
1000100000100001C11
10E0101010110101111
10001C101000C1000C1
1111111111111111111