1111111111111111111
1C1C00010E010001C01
101111010001C101101
1000C10110111100001
1011110000000000001
1000000000000000001
1011111100011110111
101C000110110000001
1011110100011101101
100000010P01C0001C1
1111111111111111111