1111111111111
10100000000C1
1100011010011
100P00E000001
1111111111111