111111111
1S00C00S1
100CPE001
100S00001
111111111