1111111
1P00C01
10CC0E1
100S001
1111111