1111111
1P00001
10C00E1
1111111