1111111
1P00C01
10CC0E1
1000001
1111111