111111111
1000C00E1
110SP0111
1CS00S0C1
111111111