111111111
1S00C00E1
1100P0111
1CS00S0C1
111111111