111111111
1S00C00S1
100CPE001
10S000001
111111111